NO Texture/no.xpm
WE Texture/we.xpm
EA Texture/ea.xpm
SO Texture/so.xpm


C 2,20,10
F 2,2,2
 

11111111111111111
110000000000000011
100000111111000001
100011   10000001
1000001  110000011
10000011110000001
10000N0100000001
10000000000000001
11111111111111111
